111111111
1CE0P00E1
111111111
