111111101
100000001
100000001
10PEC0001
100000001
111111111
